# Sushi terms compiled, with modification, from http://www.bento.com/sushivoc.html
aji	horse mackerel
akagai	ark shell
amaebi	raw shrimp
anago	conger eel
aoyagi	round clam
awabi	abalone
botan-ebi
buri	adult yellowtail
chutoro	marbled tuna belly
ebi	boiled shrimp
fugu
hamachi	young yellowtail
hamaguri	clam
hamo	pike conger
hatahata	sandfish
haze	goby
hirame	flounder
hokkigai	surf clam
horagai	trumpet shell
hotategai	scallop
ika	squid
ikura	salmon roe
inada	young yellowtail
isaki	grunt
ise-ebi	spiny lobster
iwashi	sardine
kaibashira	scallop
kajiki	swordfish
kaki	oyster
kani	crab
kanpachi
karei	flatfish
katsuo	bonito
kazunoko	herring roe
kihada	yellowfin tuna
kohada	gizzard shad
konoshiro	gizzard shad
kuruma-ebi	prawn
maaji	horse mackerel
maguro	tuna
makajiki	blue marlin
meji	young tuna
mekajiki	swordfish
mirugai	surf clam
mirukui	surf clam
ni-ika	squid simmered in soy stock
nishin	herring
ohyo	halibut
otoro	fatty tuna belly
saba	mackerel
sake	salmon
sanma	saury
sayori	halfbeak
seigo	young sea bass
shako
shima-aji	horse mackerel
shime-saba	marinated mackerel
shirauo	whitebait
shiromi	white-fleshed fish
shita-birame	sole
suzuki	sea bass
tai	sea bream
tairagai	razor-shell clam
tako	octopus
tarako	cod roe
tobiko	flying-fish roe
torigai	cockle
toro	choice tuna belly
tsubugai
unagi	eel
uni	sea urchin roe
